***************
E *    *      *
* * ** ** * ***
*    ***  *   *
* *****  **** *
*     * **    *
***** *  ** ***
*      * *    *
* **** * *** **
*  **  *  *   *
* * * ****  * *
* * *  *  *  **
* *  *  * * * X
*    *  *     *
***************