XXXXXXXXXXXXXXX
  X    X      X
X X XX XX X XXX
X    XXX  X   X
X XXXXX  XXXX X
X     X XX    X
XXXXX X  XX XXX
X      X X    X
X XXXX X XXX XX
X  XX  X  X   X
X X X XXXX  X X
X X X  X  X  XX
X X  X  X X X  
X    X  X     X
XXXXXXXXXXXXXXX